かいけい | kaikei | accounting | [sound:ic_jp_kaikei.mp3] 
ボーナス | bōnasu | bonus | [sound:ic_jp_bōnasu.mp3] 
きゅうりょう | kyūryō | wage | [sound:ic_jp_kyūryō.mp3] 
はんばい | hanbai | sale | [sound:ic_jp_hanbai.mp3] 
アイティーぶもん | aitī-bumon | IT department | [sound:ic_jp_aitī-bumon.mp3] 
しゅっちょう | shucchō | business trip | [sound:ic_jp_shucchō.mp3] 
マーケティング | māketingu | marketing | [sound:ic_jp_māketingu.mp3] 
かいけいし | kaikeishi | accountant | [sound:ic_jp_kaikeishi.mp3] 
べんごし | bengoshi | lawyer | [sound:ic_jp_bengoshi.mp3] 
つまらない | tsumaranai | boring | [sound:ic_jp_tsumaranai.mp3] 
しげきてき | shigeki-teki | exciting | [sound:ic_jp_shigeki-teki.mp3] 
にんきがある | ninki ga aru | popular | [sound:ic_jp_ninki_ga_aru.mp3] 
かるい | karui | light | [sound:ic_jp_karui.mp3] 
くらい | kurai | dark | [sound:ic_jp_kurai.mp3] 
ふまん | fuman | dissatisfied | [sound:ic_jp_fuman.mp3] 
たいしたことがない | taishita koto ga nai | insignificant | [sound:ic_jp_taishita_koto_ga_nai.mp3] 
はずかしい | hazukashii | shy | [sound:ic_jp_hazukashii.mp3] 
ゆうめい | yūmei | famous | [sound:ic_jp_yūmei.mp3] 
けいしきばらない | keishikibaranai | casual | [sound:ic_jp_keishikibaranai.mp3] 
ギター | gitā | guitar | [sound:ic_jp_gitā.mp3] 
トランペット | toranpetto | trumpet | [sound:ic_jp_toranpetto.mp3] 
バイオリン | baiorin | violin | [sound:ic_jp_baiorin.mp3] 
ピアノ | piano | piano | [sound:ic_jp_piano.mp3] 
フルート | furūto | flute | [sound:ic_jp_furūto.mp3] 
トロンボーン | toronbōn | trombone | [sound:ic_jp_toronbōn.mp3] 
サクソフォン | sakusofon | saxophone | [sound:ic_jp_sakusofon.mp3] 
ドラム | doramu | drums | [sound:ic_jp_doramu.mp3] 
ハーモニカ | hāmonika | harmonica | [sound:ic_jp_hāmonika.mp3] 
キーボード | kībōdo | keyboard | [sound:ic_jp_kībōdo.mp3] 
いたみ　 | itami | pain | [sound:ic_jp_itami.mp3] 
ほっしん | hosshin | rash | [sound:ic_jp_hosshin.mp3] 
せき | seki | cough | [sound:ic_jp_seki.mp3] 
はきけ | hakike | nausea | [sound:ic_jp_hakike.mp3] 
つかれ | tsukare | fatigue | [sound:ic_jp_tsukare.mp3] 
かゆみ | kayumi | itch | [sound:ic_jp_kayumi.mp3] 
のどがいたい | nodo ga itai | sore throat | [sound:ic_jp_nodo_ga_itai.mp3] 
はなみず | hanamizu | runny nose | [sound:ic_jp_hanamizu.mp3] 
めまいがする | memai ga suru | dizzy | [sound:ic_jp_memai_ga_suru.mp3] 
はなづまり | hanazumari | stuffy nose | [sound:ic_jp_hanazumari.mp3] 
へや | heya | room | [sound:ic_jp_heya.mp3] 
ロビー | robī | lobby | [sound:ic_jp_robī.mp3] 
ウェイクアップサービス | ueikuappu sābisu | wake-up service | [sound:ic_jp_ueikuappu_sābisu.mp3] 
スイート | suīto | suite | [sound:ic_jp_suīto.mp3] 
クレジットカード | kurejittokādo | credit card | [sound:ic_jp_kurejittokādo.mp3] 
ルームサービス | rūmu sābisu | room service | [sound:ic_jp_rūmu_sābisu.mp3] 
レシート | reshīto | receipt | [sound:ic_jp_reshīto.mp3] 
ワイファイ | waifai | Wi-Fi | [sound:ic_jp_waifai.mp3] 
よやく | yoyaku | reservation | [sound:ic_jp_yoyaku.mp3] 
あきべや | akibeya | vacancy | [sound:ic_jp_akibeya.mp3] 
たっきゅう | takkyū | ping pong | [sound:ic_jp_takkyū.mp3] 
ランニング | ranningu | running | [sound:ic_jp_ranningu.mp3] 
やきゅう | yakyū | baseball | [sound:ic_jp_yakyū.mp3] 
アイスホッケー | aisu hokkē | ice hockey | [sound:ic_jp_aisu_hokkē.mp3] 
スキー | sukī | skiing | [sound:ic_jp_sukī.mp3] 
バレーボール | barēbōru | volleyball | [sound:ic_jp_barēbōru.mp3] 
ゴルフ | gorufu | golf | [sound:ic_jp_gorufu.mp3] 
ボクシング | bokushingu | boxing | [sound:ic_jp_bokushingu.mp3] 
サイクリング | saikuringu | cycling | [sound:ic_jp_saikuringu.mp3] 
カーレース | kā rēsu | auto racing | [sound:ic_jp_kā_rēsu.mp3] 
セロテープ | serotēpu | Scotch tape | [sound:ic_jp_serotēpu.mp3] 
ゴミばこ | gomibako | garbage pail | [sound:ic_jp_gomibako.mp3] 
ふうとう | fūtō | envelope | [sound:ic_jp_fūtō.mp3] 
かみ | kami | paper | [sound:ic_jp_kami.mp3] 
ディーブイディー | dībuidī | DVD | [sound:ic_jp_dībuidī.mp3] 
ホッチキスのしん | hotchikisu no shin | staple | [sound:ic_jp_hotchikisu_no_shin.mp3] 
ホッチキス | hotchikisu | stapler | [sound:ic_jp_hotchikisu.mp3] 
ペーパークリップ | pēpā kurippu | paper clip | [sound:ic_jp_pēpā_kurippu.mp3] 
シーディー | shīdī | CD | [sound:ic_jp_shīdī.mp3] 
フォルダー | forudā | folder | [sound:ic_jp_forudā.mp3] 
かう | kau | buy | [sound:ic_jp_kau.mp3] 
たいしょくする | taishoku suru | retire | [sound:ic_jp_taishoku_suru.mp3] 
りょこうする | ryokō suru | travel | [sound:ic_jp_ryokō_suru.mp3] 
そつぎょうする | sotsugyō suru | graduate | [sound:ic_jp_sotsugyō_suru.mp3] 
ひっこす | hikkosu | move | [sound:ic_jp_hikkosu.mp3] 
うまれる | umareru | be born | [sound:ic_jp_umareru.mp3] 
しごとをえる | shigoto o eru | get a job | [sound:ic_jp_shigoto_o_eru.mp3] 
しぬ | shinu | die | [sound:ic_jp_shinu.mp3] 
こんやくする | kon'yaku　suru | engage | [sound:ic_jp_kon'yaku　suru.mp3] 
けっこんする | kekkon suru | marry | [sound:ic_jp_kekkon_suru.mp3] 
マドリード | Madorīdo | Madrid | [sound:ic_jp_Madorīdo.mp3] 
ニューデリー | Nyū Derī | New Delhi | [sound:ic_jp_Nyū_Derī.mp3] 
とうきょうと | Tōkyō to | Tokyo | [sound:ic_jp_Tōkyō_to.mp3] 
ぺきん | Pekin | Beijing | [sound:ic_jp_Pekin.mp3] 
ロンドン | Rondon | London | [sound:ic_jp_Rondon.mp3] 
パリ | Pari | Paris | [sound:ic_jp_Pari.mp3] 
ベルリン | Berurin | Berlin | [sound:ic_jp_Berurin.mp3] 
ニューヨーク | Nyū Yōku | New York | [sound:ic_jp_Nyū_Yōku.mp3] 
ローマ | Rōma | Rome | [sound:ic_jp_Rōma.mp3] 
モスクワ | Mosukuwa | Moscow | [sound:ic_jp_Mosukuwa.mp3] 
きっぷ | kippu | ticket | [sound:ic_jp_kippu.mp3] 
おうふく | ōfuku | roundtrip | [sound:ic_jp_ōfuku.mp3] 
とっきゅう | tokkyū | express train | [sound:ic_jp_tokkyū.mp3] 
ふつうでんしゃ | futsū densha | local train | [sound:ic_jp_futsū_densha.mp3] 
じこくひょう | jikokuhyō | timetable | [sound:ic_jp_jikokuhyō.mp3] 
きっぷのてんけん | kippu no tenken | ticket inspection | [sound:ic_jp_kippu_no_tenken.mp3] 
かいさつぐち | kaisatsu guchi | ticket gate | [sound:ic_jp_kaisatsu_guchi.mp3] 
プラットホーム | purattohōmu | platform | [sound:ic_jp_purattohōmu.mp3] 
きっぷじどうはんばいき | kippu jidō hanbaiki | ticket machine | [sound:ic_jp_kippu_jidō_hanbaiki.mp3] 
チケットうりば | chiketto uriba | ticket booth | [sound:ic_jp_chiketto_uriba.mp3] 
