もの | mono | thing, object | used to express a reason or cause | [sound:ic_jp_mono.mp3] |  | 
ところ | tokoro | place, spot | used to indicate a situation or a point in time | [sound:ic_jp_tokoro.mp3] |  | 
すら | sura | even, as much as | used to emphasize the extreme nature of a statement | [sound:ic_jp_sura.mp3] |  | 
のみ | nomi | only, just | used to emphasize the exclusivity of a statement | [sound:ic_jp_nomi.mp3] |  | 
どころか | dokoroka | far from, let alone | used to emphasize a contrast or contradiction to what was just said | [sound:ic_jp_dokoroka.mp3] |  | 
こそ | koso | emphasizing particles | used to emphasize a word or phrase | [sound:ic_jp_koso.mp3] |  | 
のに | noni | despite, although | used to express a contrast or unexpected outcome | [sound:ic_jp_noni.mp3] |  | 
から | kara | from, because | used to indicate a reason or cause | [sound:ic_jp_kara.mp3] |  | 
かな | kana | I wonder, maybe | used to express uncertainty or doubt | [sound:ic_jp_kana.mp3] |  | 
くらい | kurai | about, around | used to indicate an approximation or degree | [sound:ic_jp_kurai.mp3] |  | 
しかない | shikanai | have no choice but to, must | used to express inevitability or lack of alternatives | [sound:ic_jp_shikanai.mp3] |  | 
も | mo | also, too | used to add emphasis or to include additional elements in a list | [sound:ic_jp_mo.mp3] |  | 
にとって | nitotte | from the perspective of, as far as...is concerned | used to indicate a viewpoint or standpoint | [sound:ic_jp_nitotte.mp3] |  | 
けれども | keredomo | but, however | used to express a contrast or contradiction to what was just said | [sound:ic_jp_keredomo.mp3] |  | 
の | no | of, belonging to | used to indicate possession or association | [sound:ic_jp_no.mp3] |  | 
ので | node | because, since | used to indicate a reason or cause | [sound:ic_jp_node.mp3] |  | 
とも | tomo | even if, whether | used to express a conditional or hypothetical situation | [sound:ic_jp_tomo.mp3] |  | 
より | yori | than, from | used to indicate a comparison or preference | [sound:ic_jp_yori.mp3] |  | 
ね | ne | isn't it, right | used to seek agreement or confirmation | [sound:ic_jp_ne.mp3] |  | 
ばかり | bakari | only, just | used to indicate a limit or a recent action | [sound:ic_jp_bakari.mp3] |  | 
でも | demo | but, however | used to express a contrast or contradiction to what was just said | [sound:ic_jp_demo.mp3] |  | 
なり | nari | become, change into | used to indicate a change or transformation | [sound:ic_jp_nari.mp3] |  | 
ながら | nagara | while, during | used to indicate simultaneous actions or states | [sound:ic_jp_nagara.mp3] |  | 
やいなや | yainaya | as soon as, just after | used to indicate an immediate consequence or action | [sound:ic_jp_yainaya.mp3] |  | 
か | ka | or, whether | used to indicate a choice or question | [sound:ic_jp_ka.mp3] |  | 
ば | ba | if, when | used to express a conditional or hypothetical situation | [sound:ic_jp_ba.mp3] |  | 
として | toshite | as, in the capacity of | used to indicate a role or function | [sound:ic_jp_toshite.mp3] |  | 
こと | koto | thing, matter | nominalizer | [sound:ic_jp_koto.mp3] |  | 
について | nitsuite | about, concerning | particle indicating a topic or subject | [sound:ic_jp_nitsuite.mp3] |  | 
とか | toka | such as, and so on | particle indicating examples or alternatives | [sound:ic_jp_toka.mp3] |  | 
ぞ | zo | hey, listen | sentence-ending particle indicating strong emphasis or command | [sound:ic_jp_zo.mp3] |  | 
など | nado | and so on, etc. | particle indicating examples or approximate items | [sound:ic_jp_nado.mp3] |  | 
や | ya | and, or | particle indicating choices or listing items | [sound:ic_jp_ya.mp3] |  | 
なら | nara | if, in case | conditional particle indicating a hypothetical situation | [sound:ic_jp_nara.mp3] |  | 
たら | tara | if, when | conditional particle indicating a past or future event | [sound:ic_jp_tara.mp3] |  | 
ほど | hodo | about, to the extent | particle indicating a degree or approximation | [sound:ic_jp_hodo.mp3] |  | 
たり | tari | and, or, and so on | particle indicating examples or a non-exhaustive list | [sound:ic_jp_tari.mp3] |  | 
し | shi | and, also, as well | conjunctive particle indicating a continuation or addition | [sound:ic_jp_shi.mp3] |  | 
な | na | isn't it? | sentence-ending particle indicating a request for confirmation or agreement | [sound:ic_jp_na.mp3] |  | 
を | o | object particle | particle indicating the direct object of a sentence | [sound:ic_jp_o.mp3] |  | 
さ | sa | emphasis particle | sentence-ending particle indicating emphasis or assertion | [sound:ic_jp_sa.mp3] |  | 
さえ | sae | even, if only | particle indicating a sufficient condition or minimum requirement | [sound:ic_jp_sae.mp3] |  | 
ぜ | ze | hey, come on | sentence-ending particle indicating strong emphasis or urging | [sound:ic_jp_ze.mp3] |  | 
と | to | and, with | particle indicating a parallel or accompanying item | [sound:ic_jp_to.mp3] |  | 
やら | yara | and so on, and all that | particle indicating a non-exhaustive list or examples | [sound:ic_jp_yara.mp3] |  | 
は | wa | topic particle | particle indicating the topic of a sentence | [sound:ic_jp_wa.mp3] |  | 
で | de | at, by, with | particle indicating the location or means of an action | [sound:ic_jp_de.mp3] |  | 
よ | yo | hey, listen, you know | sentence-ending particle indicating emphasis, urgency, or assertion | [sound:ic_jp_yo.mp3] |  | 
へ | e | to, towards | particle indicating direction or destination | [sound:ic_jp_e.mp3] |  | 
しか | shika | only, nothing but | particle indicating a restriction or limitation | [sound:ic_jp_shika.mp3] |  | 
かしら | kashira | I wonder, perhaps | sentence-ending particle indicating a question or uncertainty | [sound:ic_jp_kashira.mp3] |  | 
に | ni | in, at, on | particle indicating location, time, or manner | [sound:ic_jp_ni.mp3] |  | 
が | ga | subject particle | particle indicating the subject of a sentence | [sound:ic_jp_ga.mp3] |  | 
ものの | monono | although, despite | conjunctive particle indicating a contrast or concession | [sound:ic_jp_monono.mp3] |  | 
だの | dano | and, or | particle indicating examples or a non-exhaustive list | [sound:ic_jp_dano.mp3] |  | 
だけ | dake | only, just | particle indicating a restriction or limitation | [sound:ic_jp_dake.mp3] |  | 
わ | wa | sentence-ending particle | sentence-ending particle indicating emphasis or assertion | [sound:ic_jp_wa.mp3] |  | 
