あるいは | aruiwa | or; either; maybe; perhaps; possibly  ...  | [sound:ic_nrkt_aruiwa.mp3]
ばかりに | bakari ni | simply because; on account of ...  (negative result) | [sound:ic_nrkt_bakarini.mp3]
どうやら | dou yara | possibly; apparently; seems like; somehow; barely  ...  | [sound:ic_nrkt_douyara.mp3]
どうせ | douse | anyhow; in any case; at any rate; after all; no matter what | [sound:ic_nrkt_douse.mp3]
ふたたび | futatabi | again; once more | [sound:ic_nrkt_futatabi.mp3]
ぎゃくに | gyaku ni | conversely; on the contrary  ...  | [sound:ic_nrkt_gyakuni.mp3]
はんめん | hanmen | while, although; on the other hand ...  | [sound:ic_nrkt_hanmen.mp3]
はたして | hatashite | as was expected; sure enough; really; actually  ...  | [sound:ic_nrkt_hatashite.mp3]
いちおう | ichiou | more or less; pretty much; roughly; tentatively  ...  | [sound:ic_nrkt_ichiou.mp3]
いがい | igai | with the exception of; excepting  ...  | [sound:ic_nrkt_igai.mp3]
いじょうに | ijou ni | more than; not less than; beyond  ...  | [sound:ic_nrkt_ijouni.mp3]
いきなり | ikinari | abruptly; suddenly; all of a sudden; without warning | [sound:ic_nrkt_ikinari.mp3]
いっきに | ikki ni | in one go; without stopping; all at once; immediately; instantly; right away  ...  | [sound:ic_nrkt_ikkini.mp3]
いったん | ittan | once; for a short time; briefly; temporarily | [sound:ic_nrkt_ittan.mp3]
まだしも | madashimo | rather; better​  ...  | [sound:ic_nrkt_madashimo.mp3]
まったく ... ない | mattaku ... nai | not at all  ...  | [sound:ic_nrkt_mattaku...nai.mp3]
もともと | motomoto | originally, by nature, from the start | [sound:ic_nrkt_motomoto.mp3]
なお | nao | still; yet​; furthermore; in addition  ...  | [sound:ic_nrkt_nao.mp3]
おそらく | osoraku | perhaps; likely; probably; I dare say  ...  | [sound:ic_nrkt_osoraku.mp3]
ろくに ... ない | roku ni ... nai | not well; not enough; improperly; insufficiently; unsatisfactorily​  ...  | [sound:ic_nrkt_rokuni...nai.mp3]
さいさん | saisan | again and again; repeatedly | [sound:ic_nrkt_saisan.mp3]
さいわいなことに | saiwai na koto ni | fortunately; luckily; thankfully  ...  | [sound:ic_nrkt_saiwainakotoni.mp3]
さっそく | sassoku | at once; immediately; without delay; promptly | [sound:ic_nrkt_sassoku.mp3]
せっかく | sekkaku | especially; (thank you for) troubling to, going to great pains for  ...  | [sound:ic_nrkt_sekkaku.mp3]
せめて | semete | at least; at most  ...  | [sound:ic_nrkt_semete.mp3]
しだいに | shidai ni | gradually (progress into a state); in sequence; in order | [sound:ic_nrkt_shidaini.mp3]
そのうえ | sono ue | besides; in addition; furthermore  ...  | [sound:ic_nrkt_sonoue.mp3]
すえに | sue ni | finally; after; following; at the end/ conclusion of  ...  | [sound:ic_nrkt_sueni.mp3]
すこしも ... ない | sukoshi mo ... nai | not one bit; not even a little  ...  | [sound:ic_nrkt_sukoshimo...nai.mp3]
すくなくとも | sukunaku tomo | at least  ...  | [sound:ic_nrkt_sukunakutomo.mp3]
ただちに | tadachi ni | at once; immediately; directly; in person; automatically  ...  | [sound:ic_nrkt_tadachini.mp3]
とどうじに | to douji ni | at the same time as; while; simultaneously  ...  | [sound:ic_nrkt_todoujini.mp3]
とっくに | tokku ni | long ago; already; a long time ago | [sound:ic_nrkt_tokkuni.mp3]
はもとより | wa moto yori | also; let alone; from the beginning | [sound:ic_nrkt_wamotoyori.mp3]
はともかく | wa tomokaku | anyhow; anyway; regardless; in any case; whether or not  ...  | [sound:ic_nrkt_watomokaku.mp3]
わずかに | wazuka ni | slightly; only; barely; narrowly  ...  | [sound:ic_nrkt_wazukani.mp3]
やがて | yagate | before long; soon; almost; eventually  ...  | [sound:ic_nrkt_yagate.mp3]
よほど / よっぽど | yohodo / yoppodo | very; greatly; much; to a large extent | [sound:ic_nrkt_yohodo/yoppodo.mp3]
ようするに | you suru ni | in short; in a word; to sum up; to put it simply  ...  | [sound:ic_nrkt_yousuruni.mp3]
