あかり | akari | light; illumination; glow; gleam | [sound:ic_nrkt_akari.mp3]
あくま | akuma | devil; demon; fiend; Satan | [sound:ic_nrkt_akuma.mp3]
あんき | anki | memorization; learning by heart | [sound:ic_nrkt_anki.mp3]
あらた | arata | new; fresh; novel | [sound:ic_nrkt_arata.mp3]
あつまり | atsumari | gathering; meeting; assembly; collection; attendance | [sound:ic_nrkt_atsumari.mp3]
ぶぶん | bubun | portion; section; part | [sound:ic_nrkt_bubun.mp3]
ぶん | bun | part; segment; share; ration | [sound:ic_nrkt_bun.mp3]
ぶんめい | bunmei | civilization; culture | [sound:ic_nrkt_bunmei.mp3]
ぶんせき | bunseki | analysis | [sound:ic_nrkt_bunseki.mp3]
ぶんや | bunya | field; sphere; realm; division; branch | [sound:ic_nrkt_bunya.mp3]
ちちおや | chichioya | father | [sound:ic_nrkt_chichioya.mp3]
ちへいせん | chiheisen | horizon (related to land)​ | [sound:ic_nrkt_chiheisen.mp3]
ちい | chii | (social) position; status | [sound:ic_nrkt_chii.mp3]
ちょうき | chouki | long-term | [sound:ic_nrkt_chouki.mp3]
ちゅう | chuu | during; while; medium; middle | [sound:ic_nrkt_chuu.mp3]
ちゅうがく | chuugaku | junior high school; middle school | [sound:ic_nrkt_chuugaku.mp3]
ちゅうしょく | chuushoku | lunch; midday meal | [sound:ic_nrkt_chuushoku.mp3]
だいぶぶん | daibubun | most part; greater part; majority | [sound:ic_nrkt_daibubun.mp3]
だめ | dame | no good; cannot | [sound:ic_nrkt_dame.mp3]
だんし | danshi | youth; young man | [sound:ic_nrkt_danshi.mp3]
であい | deai | meeting; rendezvous; encounter | [sound:ic_nrkt_deai.mp3]
どくしょ | dokusho | reading | [sound:ic_nrkt_dokusho.mp3]
どりょく | doryoku | effort; exertion; endeavor; hard work; striving | [sound:ic_nrkt_doryoku.mp3]
えん | en | yen; Japanese monetary unit; circle | [sound:ic_nrkt_en.mp3]
ふり | furi | disadvantage; handicap; unfavorable position | [sound:ic_nrkt_furi.mp3]
ふそく | fusoku | insufficiency; shortage; deficiency; lack; dearth | [sound:ic_nrkt_fusoku.mp3]
がいこう | gaikou | diplomacy | [sound:ic_nrkt_gaikou.mp3]
がいしゅつ | gaishutsu | going out; outing; leaving (one's home, office, etc.) | [sound:ic_nrkt_gaishutsu.mp3]
がっき | gakki | school term; semester | [sound:ic_nrkt_gakki.mp3]
がく | gaku | learning; education; study of | [sound:ic_nrkt_gaku.mp3]
がくもん | gakumon | scholarship; study; learning | [sound:ic_nrkt_gakumon.mp3]
がくしゃ | gakusha | scholar | [sound:ic_nrkt_gakusha.mp3]
がくしゅう | gakushuu | study; learning; tutorial | [sound:ic_nrkt_gakushuu.mp3]
ぎちょう | gichou | chairman; president; moderator | [sound:ic_nrkt_gichou.mp3]
ぎかい | gikai | congress; parliament; diet; legislative assembly | [sound:ic_nrkt_gikai.mp3]
ごがく | gogaku | study of foreign languages; linguistics | [sound:ic_nrkt_gogaku.mp3]
ははおや | hahaoya | mother | [sound:ic_nrkt_hahaoya.mp3]
はくぶつかん | hakubutsukan | museum | [sound:ic_nrkt_hakubutsukan.mp3]
はんばい | hanbai | sales; selling; marketing | [sound:ic_nrkt_hanbai.mp3]
はつめい | hatsumei | invention | [sound:ic_nrkt_hatsumei.mp3]
ひん | hin | elegance, article | [sound:ic_nrkt_hin.mp3]
ひとこと | hitokoto | single word; a few words; brief comment | [sound:ic_nrkt_hitokoto.mp3]
ひとりひとり | hitorihitori | one by one; each; one at a time | [sound:ic_nrkt_hitorihitori.mp3]
ほんもの | honmono | genuine article; real thing; real deal​ | [sound:ic_nrkt_honmono.mp3]
ほんにん | honnin | the person in question; the person themselves; said person | [sound:ic_nrkt_honnin.mp3]
いっち | icchi | agreement; union; match​; coincidence | [sound:ic_nrkt_icchi.mp3]
いちじ | ichiji | one o'clock | [sound:ic_nrkt_ichiji.mp3]
いっか | ikka | a family; a household; a home; one's family; whole family | [sound:ic_nrkt_ikka.mp3]
いっぱん | ippan | general; universal; ordinary; average; common | [sound:ic_nrkt_ippan.mp3]
いっぽう | ippou | one (esp. of two); one way; the other direction; although | [sound:ic_nrkt_ippou.mp3]
いっしょう | isshou | whole life; a lifetime; a generation | [sound:ic_nrkt_isshou.mp3]
いっしゅ | isshu | species; kind; variety | [sound:ic_nrkt_isshu.mp3]
いっしゅん | isshun | instant; moment; for an instant | [sound:ic_nrkt_isshun.mp3]
いっそう | issou | much more; still more; all the more; single layer; sooner; preferably​ | [sound:ic_nrkt_issou.mp3]
いったい | ittai | (what) the heck; (why) in the world | [sound:ic_nrkt_ittai.mp3]
じゃま | jama | hindrance | [sound:ic_nrkt_jama.mp3]
かがく | kagaku | chemistry | [sound:ic_nrkt_kagaku.mp3]
かい | kai | meeting; assembly; party; association; club | [sound:ic_nrkt_kai.mp3]
かいいん | kai'in | member | [sound:ic_nrkt_kai'in.mp3]
かいがい | kaigai | foreign; abroad; overseas | [sound:ic_nrkt_kaigai.mp3]
かいごう | kaigou | meeting; assembly; gathering; association | [sound:ic_nrkt_kaigou.mp3]
かいけい | kaikei | finance; account; treasurer; bill | [sound:ic_nrkt_kaikei.mp3]
かいし | kaishi | start; commencement; beginning; initiation​ | [sound:ic_nrkt_kaishi.mp3]
かもく | kamoku | (school) subject; curriculum; course | [sound:ic_nrkt_kamoku.mp3]
けんり | kenri | right; privilege | [sound:ic_nrkt_kenri.mp3]
きほん | kihon | basics; fundamentals; basis; foundation | [sound:ic_nrkt_kihon.mp3]
きじ | kiji | article; news story; report; account | [sound:ic_nrkt_kiji.mp3]
きみ | kimi | sensation; feeling​; tendency | [sound:ic_nrkt_kimi.mp3]
きねん | kinen | commemoration; celebration; honoring the memory of something | [sound:ic_nrkt_kinen.mp3]
きにゅう | kinyuu | entry; filling in; filling out | [sound:ic_nrkt_kinyuu.mp3]
きおく | kioku | memory; recollection; remembrance | [sound:ic_nrkt_kioku.mp3]
きしゃ | kisha | reporter; journalist | [sound:ic_nrkt_kisha.mp3]
きたい | kitai | expectation; anticipation; hope | [sound:ic_nrkt_kitai.mp3]
こっか | kokka | state; country; nation | [sound:ic_nrkt_kokka.mp3]
こっかい | kokkai | National Diet; legislative assembly of Japan;  parliament; congress | [sound:ic_nrkt_kokkai.mp3]
こっきょう | kokkyou | national border | [sound:ic_nrkt_kokkyou.mp3]
こくご | kokugo | national language | [sound:ic_nrkt_kokugo.mp3]
こくみん | kokumin | people (of a country); nation; citizen; national | [sound:ic_nrkt_kokumin.mp3]
こんご | kongo | from now on; hereafter | [sound:ic_nrkt_kongo.mp3]
こんかい | konkai | now; this time; lately | [sound:ic_nrkt_konkai.mp3]
こうそく | kousoku | high-speed; rapid; express | [sound:ic_nrkt_kousoku.mp3]
くんれん | kunren | training; drill; practice; discipline | [sound:ic_nrkt_kunren.mp3]
きょうかしょ | kyoukasho | textbook; coursebook; schoolbook | [sound:ic_nrkt_kyoukasho.mp3]
きょうりょく | kyouryoku | cooperation; collaboration | [sound:ic_nrkt_kyouryoku.mp3]
きょうりょく | kyouryoku | powerful; strong | [sound:ic_nrkt_kyouryoku.mp3]
きゅうしゅう | kyuushuu | absorption; suction; attraction | [sound:ic_nrkt_kyuushuu.mp3]
きゅうそく | kyuusoku | rapid (e.g. progress) | [sound:ic_nrkt_kyuusoku.mp3]
まじめ | majime | serious; earnest | [sound:ic_nrkt_majime.mp3]
まっか | makka | bright red; deep red; flushed (of face) | [sound:ic_nrkt_makka.mp3]
まんいち | manichi | emergency; unlikely event​; by some chance; by some possibility | [sound:ic_nrkt_manichi.mp3]
まんぞく | manzoku | satisfaction; contentment;​ sufficient; enough | [sound:ic_nrkt_manzoku.mp3]
めし | meshi | cooked rice; meal | [sound:ic_nrkt_meshi.mp3]
みかた | mikata | friend; ally; supporter; taking sides with; supporting | [sound:ic_nrkt_mikata.mp3]
みりょく | miryoku | charm; fascination; glamour; attraction; appeal | [sound:ic_nrkt_miryoku.mp3]
もくよう | mokuyou | Thursday | [sound:ic_nrkt_mokuyou.mp3]
なかば | nakaba | middle; half; semi; halfway; partly | [sound:ic_nrkt_nakaba.mp3]
ねっしん | nesshin | enthusiastic; eager | [sound:ic_nrkt_nesshin.mp3]
にほん | nihon | Japan | [sound:ic_nrkt_nihon.mp3]
のうりょく | nouryoku | ability; faculty | [sound:ic_nrkt_nouryoku.mp3]
にゅうじょう | nyuujou | entrance; admission; entering | [sound:ic_nrkt_nyuujou.mp3]
おひる | ohiru | lunch; midday; daytime | [sound:ic_nrkt_ohiru.mp3]
れんぞく | renzoku | continuation; succession; series | [sound:ic_nrkt_renzoku.mp3]
りえき | rieki | profit; gains; benefit | [sound:ic_nrkt_rieki.mp3]
りこう | rikou | clever; intelligent; wise; bright; sharp | [sound:ic_nrkt_rikou.mp3]
りゅうがく | ryuugaku | studying abroad | [sound:ic_nrkt_ryuugaku.mp3]
さくひん | sakuhin | work of art; performance | [sound:ic_nrkt_sakuhin.mp3]
さゆう | sayuu | left and right | [sound:ic_nrkt_sayuu.mp3]
せいちょう | seichou | growth; development; growing up; becoming an adult | [sound:ic_nrkt_seichou.mp3]
せいひん | seihin | manufactured goods; finished goods; product | [sound:ic_nrkt_seihin.mp3]
せいねん | seinen | youth; young man | [sound:ic_nrkt_seinen.mp3]
しげき | shigeki | stimulus; impetus; incentive; encouragement; motivation; provocation; excitement; thrill | [sound:ic_nrkt_shigeki.mp3]
しほん | shihon | funds; capital | [sound:ic_nrkt_shihon.mp3]
しな | shina | article; item; thing; goods; stock; quality | [sound:ic_nrkt_shina.mp3]
しんちょう | shinchou | body height; stature | [sound:ic_nrkt_shinchou.mp3]
しんがく | shingaku | entering a higher-level school (often university) | [sound:ic_nrkt_shingaku.mp3]
してん | shiten | branch office; branch store​ | [sound:ic_nrkt_shiten.mp3]
しよう | shiyou | use; application; employment; utilization. | [sound:ic_nrkt_shiyou.mp3]
しょくひん | shokuhin | food; food products | [sound:ic_nrkt_shokuhin.mp3]
しょもつ | shomotsu | book; volume | [sound:ic_nrkt_shomotsu.mp3]
しょるい | shorui | document; official papers | [sound:ic_nrkt_shorui.mp3]
しょさい | shosai | study; library; den; home office; reading room | [sound:ic_nrkt_shosai.mp3]
しょうばい | shoubai | trade; business; commerce; transaction; occupation | [sound:ic_nrkt_shoubai.mp3]
しょうがくきん | shougakukin | scholarship; stipend; student loan | [sound:ic_nrkt_shougakukin.mp3]
しょうご | shougo | midday | [sound:ic_nrkt_shougo.mp3]
しょうひん | shouhin | commodity; article of commerce; goods; stock; merchandise | [sound:ic_nrkt_shouhin.mp3]
しょうじょ | shoujo | little girl; maiden; young lady | [sound:ic_nrkt_shoujo.mp3]
しょうめい | shoumei | proof; verification; certification | [sound:ic_nrkt_shoumei.mp3]
しょうねん | shounen | boy; juvenile; young boy; youth; lad | [sound:ic_nrkt_shounen.mp3]
しょうしょう | shoushou | just a minute; small quantity | [sound:ic_nrkt_shoushou.mp3]
しょうたい | shoutai | invitation | [sound:ic_nrkt_shoutai.mp3]
しゅう | shuu | week | [sound:ic_nrkt_shuu.mp3]
しゅうちゅう | shuuchuu | concentration; focusing; centralization; integration | [sound:ic_nrkt_shuuchuu.mp3]
しゅうだん | shuudan | group; mass | [sound:ic_nrkt_shuudan.mp3]
しゅうかく | shuukaku | harvest; crop; fruits (of one's labors) | [sound:ic_nrkt_shuukaku.mp3]
しゅうかん | shuukan | week | [sound:ic_nrkt_shuukan.mp3]
しゅうかん | shuukan | weekly publication | [sound:ic_nrkt_shuukan.mp3]
しゅうにゅう | shuunyuu | income; receipts; revenue; salary | [sound:ic_nrkt_shuunyuu.mp3]
そくど | sokudo | speed; velocity; pace; rate | [sound:ic_nrkt_sokudo.mp3]
たいはん | taihan | majority; more than half; most; largely; mainly | [sound:ic_nrkt_taihan.mp3]
たいかい | taikai | convention; rally; conference; tournament; | [sound:ic_nrkt_taikai.mp3]
たしょう | tashou | more or less; somewhat; a little; a few; some | [sound:ic_nrkt_tashou.mp3]
てじな | tejina | magic trick; illusion | [sound:ic_nrkt_tejina.mp3]
てつがく | tetsugaku | philosophy | [sound:ic_nrkt_tetsugaku.mp3]
てつや | tetsuya | staying up all night | [sound:ic_nrkt_tetsuya.mp3]
とち | tochi | plot of land; lot; soil | [sound:ic_nrkt_tochi.mp3]
とかい | tokai | (big) city | [sound:ic_nrkt_tokai.mp3]
としょ | tosho | books | [sound:ic_nrkt_tosho.mp3]
つうがく | tsuugaku | commuting to school; school commute | [sound:ic_nrkt_tsuugaku.mp3]
うんてん | unten | operation; driving | [sound:ic_nrkt_unten.mp3]
わるぐち | waruguchi | slander; bad-mouthing; abuse; insult; speaking ill (of) | [sound:ic_nrkt_waruguchi.mp3]
よあけ | yoake | dawn; daybreak | [sound:ic_nrkt_yoake.mp3]
よぶん | yobun | extra; excess; surplus | [sound:ic_nrkt_yobun.mp3]
よみ | yomi | reading (of a kanji, situation, etc) | [sound:ic_nrkt_yomi.mp3]
よなか | yonaka | middle of the night; dead of night | [sound:ic_nrkt_yonaka.mp3]
ゆいいつ | yuiitsu | only; sole; unique | [sound:ic_nrkt_yuiitsu.mp3]
ゆにゅう | yunyuu | import; importation; introduction | [sound:ic_nrkt_yunyuu.mp3]
ゆしゅつ | yushutsu | export; exportation​ | [sound:ic_nrkt_yushutsu.mp3]
ゆうべ | yuube | evening /  last night; yesterday evening | [sound:ic_nrkt_yuube.mp3]
ゆうり | yuuri | advantageous; favorable; profitable | [sound:ic_nrkt_yuuri.mp3]
ぜんこく | zenkoku | the whole country | [sound:ic_nrkt_zenkoku.mp3]
